GGGGGGGGGGGGGGGGGGGGGGGGGGG
GGGGWWGGGbbGGGGGGGGGGGGGGGG
GGGGWWGGGbbGGGGGGGGGGGbbGGG
GGGGWWGGGGGGGGGGGGGGGbbGGGG
GGGGWWGGGGGGGGGGGGGbbGGGGGG
GGGGWWGGGGGGGGGGGGGGGGGGGGG
GGGGWWGGGGGGGGGGGGGGGGGGGGG
GGGGGGGGGGGGGGGGGGGGGGGGGGG
GGGGGGGGGGGWWWWGGGGGGGGGGGG
GGGGGGGGGGGWWWWGGGGGGGGGGGG
GGGGGGGGGGGWWWWGGGGGGGGGGGG
GGGGGGGGGGGWWWWGGGGGGGGGGGG
GGGGGGGGGGGGGGGGGGGGGWWGGGG
GGGGGGGGGGGGGGGGGGGGGWWGGGG
GGGGGbbGGGGGGGGGGGGGGWWGGGG
GGGGbbGGGGGGGGGGGGGGGWWGGGG
GGGGGGbbGGGGGGGGGGGGGWWGGGG
GGGGGGGGGGGGGGGGGGGGGGGGGGG