bbbbbbbbbbbbGGGbbbbbbbbbbbb
bGGGGGGGGGGGGGGGGGGGGGGGGGb
bGGGGGGGGGGGGGGGGGGGGGGGGGb
bGGGGGGGGGGGGGGGGGGGGGGGGGb
bGGGGGGGGGGGGGGGGGGGGGGGGGb
bGGGGGGGbbbbbbbbGGGGGGGGGGb
bGGGGGGGGGGGGGGGGGGGGGGGGGb
GGGGGGGGGGGGGGGGGGGGGGGGGGG
GGGGGGGGGGGGGGGGGGGGGGGGGGG
GGGGGGGGGGGGGGGGGGGGGGGGGGG
bGGGGGGGGGGGGGGGGGGGGGGGGGb
bGGGGGGGbGGGGGGbGGGGGGGGGGb
bGGGGGbbGGGGGGGGbbGGGGGGGGb
bGGGGGGGGGGGGGGGGGGGGGGGGGb
bGGGGGGGGGGGGGGGGGGGGGGGGGb
bGGGGGGGGGGGGGGGGGGGGGGGGGb
bGGGGGGGGGGGGGGGGGGGGGGGGGb
bbbbbbbbbbbbGGGbbbbbbbbbbbb