bbbbbbbbbbbbGGGbbbbbbbbbbbb
bGGGWWGGGGGGGGGGGGGGGGGGGGb
bGGGWWGGGGGGGGGGGGGGGGGGGGb
bGGGWWGGGGGGGGGGGGGGGGGGGGb
bGGGWWGGGGGGGGGGGGGGGGGGGGb
bGGGWWGGGGGGGGGGGGGGGGGGGGb
bGGGWWGGGGGGGGGGGGGGGGGGGGb
GGGGGGGGGGGGGGGGGGGGGGGGGGG
GGGGGGGGGGGWWWWGGGGGGGGGGGG
GGGGGGGGGGGWWWWGGGGGGGGGGGG
bGGGGGGGGGGWWWWGGGGGGGGGGGb
bGGGGGGGGGGWWWWGGGGGGGGGGGb
bGGGGGGGGGGGGGGGGGGGGWWGGGb
bGGGGGGGGGGGGGGGGGGGGWWGGGb
bGGGGGGGGGGGGGGGGGGGGWWGGGb
bGGGGGGGGGGGGGGGGGGGGWWGGGb
bGGGGGGGGGGGGGGGGGGGGWWGGGb
bbbbbbbbbbbbGGGbbbbbbbbbbbb