bbbbbbbbbbbbGGGbbbbbbbbbbbb
bGGGGGGGGGGGGGGGGGGGGGGGGGb
bGGWWGGGGGGGGGGGGGGGGWWGGGb
bGGWWGGGGGGGGGGGGGGGGWWGGGb
bGGGGGbGGGGGGGGGGGGbGGGGGGb
bGGGGGbGGGGGGGGGGGGbGGGGGGb
bGGGbbbGGGGGGGGGGGGbbbGGGGb
GGGGGGGGGGGGWWWGGGGGGGGGGGG
GGGGGGGGGGGGWbWGGGGGGGGGGGG
GGGGGGGGGGGGWWWGGGGGGGGGGGG
bGGGGGGGGGGGGGGGGGGGGGGGGGb
bGGGGGGGGGGGGGGGGGGbbbGGGGb
bGGGGGbbbGGGGGGGGGGbGGGGGGb
bGGGGGGGbGGGGGGGGGGbGGGGGGb
bGGGWWGGbGGGGGGGGGGGGWWGGGb
bGGGWWGGGGGGGGGGGGGGGWWGGGb
bGGGGGGGGGGGGGGGGGGGGGGGGGb
bbbbbbbbbbbbGGGbbbbbbbbbbbb
