bbbbbbbbbbbbGGGbbbbbbbbbbbb
bGGGWWGGGGGGGGGGGGGGGGGGGGb
bGGGWWGGGGGGGGGGGbbbbbbGGGb
bGGGWWGGGGGGGGGGGbbbbbbGGGb
bGGGWWGGGGGGGGGGGGGGGGGGGGb
bGGGWWGGGGGGGGGGGGGGGGGGGGb
bGGGWWGGGGGGGGGGGGGGGGGGGGb
GGGGGGGGGGGGGGGGGGGGGGGGGGG
GGGGGGGGGGGGGGGGGGGGGGGGGGG
GGGGGGGGGGGGGGGGGGGGGGGGGGG
bGGGGGGGGGGGGGGGGGGGGGGGGGb
bGGGGGGGGGGGGGGGGGGGGGGGGGb
bGGGGGGGGGGGGGGGGGGGGWWGGGb
bGGGGGGGGGGGGGGGGGGGGWWGGGb
bGGbbbbbbGGGGGGGGGGGGWWGGGb
bGGbbbbbbGGGGGGGGGGGGWWGGGb
bGGGGGGGGGGGGGGGGGGGGWWGGGb
bbbbbbbbbbbbGGGbbbbbbbbbbbb