GWWGGGGGGGGGGGGGGGGGGGGGGGG
GGGGGGGGGGGWWGGGGGGGGGGGGGG
GGGGGGGGGGGWWGGGGGGGGGGGGGG
GGGGGGGGGGWWWWWGGGGGGGGGGGG
GGGGGGGGGGGGGGGGGGGGGGGGGGG
GGGGGGGGGGGGGGGGGGGGGGGGGGG
GGGGGGGGGGGGbbbbbGGGGGGGGGG
GGGGGGGGGGGGbGGGbGGGGGGGGGG
GGGGGGGGGGGGbGGGbGGGGGGGGGG
GGGGGGGGGGGGbGGGbGGGGGGGGGG
GGGGGGGGGGGGbGGGbGGGGGGGGGG
GGGGGGGGGGGGbGGGbGGGGGGGGGG
GGGGGGGGGGGGbbbbbGGGGGGGGGG
GGGGGGGGGGGGGGGGGGGGGGGGGGG
GGGGGGGWWWWWWGGGGGGGGGGGGGG
GGGGGGGGGGWWWWWWWWbGGGGGGGG
GGGGGGGGGGGGGGGGGGGGGGGGGGG
GGGGGGGGGGGGGGGGGGGGGGGGGGG