GGGGGGGGGGGGGGGGGGGGGGGGGGG
GGGGGGGGGGGGGGGGGGGGbbbGGGG
GGGGGGGGGGGGGGGGGGbGGGbGGGG
GGGGGGGGGGGGGGGGGGbbGGGGGGG
GGGGGGGGGGGGGGGGGGGGGGGGGGG
GGGGGGGGbbbbbbbbGGGGGGGGGGG
GGGGGGGGGGGGGGGGGGGGGGGGGGG
GGGGGGGGGGGGGGGGGGGGGGGGGGG
GGGGGGGGGGGGGGGGGGGGGGGGGGG
GGGGGGGGGGGGGGGGGGGGGGGGGGG
GGGGGGGGGGGGGGGGGGGGGGGGGGG
GGGGGGGGbGGGGGGbGGGGGGGGGGG
GGGGGGGGGGGGGGGGbbGGbGGGGGG
GGGGbbbGbGGGGGGGGGGGbGGGGGG
GGGGGGbGbGGGGGGGGGGGbGGGGGG
GGGGGGGGGGGGGGGGGGGGbGGGGGG
GGbGGGbGGGGGGGGGGGGGGGGGGGG
GGGGGGGGGGGGGGGGGGGGGGGGGGG