bbbbbbbbbbbbGGGbbbbbbbbbbbb
bGGGGGGGGGGGGGGGGGGGGGGGGGb
bGGWWGGGGGGGGGGGGGGGGWWGGGb
bGGWWGGGGGGGGGGGGGGGGWWGGGb
bGGGGGGGGGGGGGGGGGGGGGGGGGb
bGGGGGGGGGGGGGGGGGGGGGGGGGb
bGGGGGGGGGGGGGGGGGGGGGGGGGb
GGGGGGGGGGGGWWWGGGGGGGGGGGG
GGGGGGGGGGGGWbWGGGGGGGGGGGG
GGGGGGGGGGGGWWWGGGGGGGGGGGG
bGGGGGGGGGGGGGGGGGGGGGGGGGb
bGGGGGGGGGGGGGGGGGGGGGGGGGb
bGGGGGGGGGGGGGGGGGGGGGGGGGb
bGGGGGGGGGGGGGGGGGGGGGGGGGb
bGGGWWGGGGGGGGGGGGGGGWWGGGb
bGGGWWGGGGGGGGGGGGGGGWWGGGb
bGGGGGGGGGGGGGGGGGGGGGGGGGb
bbbbbbbbbbbbGGGbbbbbbbbbbbb