GGGGGGGGGGGGGGGGGGGGGGGGGGG
GGGGGGGGGGGGGGGGGGGGGGGGGGG
GGGWWGGGGGGGGGGGGGGGGWWGGGG
GGGWWGGGGGGGGGGGGGGGGWWGGGG
GGGGGGbGGGGGGGGGGGGbGGGGGGG
GGGGGGbGGGGGGGGGGGGbGGGGGGG
GGGGbbbGGGGGGGGGGGGbbbGGGGG
GGGGGGGGGGGGWWWGGGGGGGGGGGG
GGGGGGGGGGGGWbWGGGGGGGGGGGG
GGGGGGGGGGGGWWWGGGGGGGGGGGG
GGGGGGGGGGGGGGGGGGGGGGGGGGG
GGGGGGGGGGGGGGGGGGGbbbGGGGG
GGGGGGbbbGGGGGGGGGGbGGGGGGG
GGGGGGGGbGGGGGGGGGGbGGGGGGG
GGGGWWGGbGGGGGGGGGGGGWWGGGG
GGGGWWGGGGGGGGGGGGGGGWWGGGG
GGGGGGGGGGGGGGGGGGGGGGGGGGG
GGGGGGGGGGGGGGGGGGGGGGGGGGG
